1111111
1P0X0C1
1000001
100X0E1
1111111
