11111
1PCE1
10101
1XM01
11111
