11111111111111111111111111111
10P00000000000000001000000001
1C000000000000000000000000C01
10000000000E00000100000000C01
10X00000000000000X0000000C001
11111111111111111111111111111