11111111111111111111111111111
10P00000000000000001000000001
1C000000000000000000000000C01
10000000000000000100000000C01
10000000000000000000000000C01
11111111111111111111111111111