11111111
1P0000E1
10011001
10C11001
10011001
10000001
11111111
