111111
1P1CE1
101001
100001
111111
