1111111
1P000C1
1000101
1000101
100C1E1
1111111
