11111111111111111111111111111111111111111111111111111111111111111
10000000000000000010000000000000000000000100000000000000000000001
1000P000000000000010000000000000000000000100000000000000000000001
10000000000000000010000000000000000000000100000000000000000000001
10000000000000000000000000000000000000000000000000000000000000001
10000000000000000010000000000000000000000100000000000000000000001
10000000000000000010000000000000000000000100000000000000000000001
100000000000000000100000000000000000000001000000000000000X0000001
10000000000000000010000000000000000000000100000000000000000000001
10000000000000000010000000000000000000000100000000000000000000001
1000000000000000001000000000000000000000010000000000000000000E001
1000000000000000001000000000000000000000010000000000000000XX0CCX1
11111111111111111111111111111111111111111111111111111111111111111